QQQQQQQQQQQQQQQQQQQQQQQQQQQQQQQQQQQQQQQQQQQQQQQQQQQQQQ
QQQQQQQQQQQQQQQQQQQQQQQQQQQQQQQQQQQQQQQQQQQQQQQQQQQQQQ
QQQQQQQQQQQQQQQQQQQQQQQQQQQQQQQQQQQQQQQQQQQQQQQQQQQQQQ
QQQQQQQQQQQQQQQQQQQQQQQQQQQQQQQQQQQQQQQQQQQQQQQQQQQQQQ
QQQQQQQQQQQQQQQQQQQQQQQQQQQQQQQQQQQQQQQQQQQQQQQQQQQQQQ
QQQQQQQQQQQQQQQQQQQQQQQQQQQQQQQQQQQQQQQQQQQQQQQQQQQQQQ
QQQQQQQqqqqqqqqqqqqqqqqqqqqqqqqqqqqqqqqqqqqqqqqqQQQQQQ
QQQQQQQqQQQQQQQQQQQQQQQQQQQQQQQQQQQQQQQQQQQQQQQqQQQQQQ
QQQQQQQqQQLLLLLLLLLLLLLLLLLLLLLLLLLLLLLLLLQQQQQqqQQQQQ
QQQQQqqqQQLQQQQQQQQQQQQQQQQQQLQQQQQQQQQQQLQQQQQQqQQQQQ
QQQQQqQQQQLQQQQQQQQQQQQQQQQQQLQQQQQQQQQQQLQQQQQQqQQQQQ
QQQQQqQQQQLQQQQQQQQQQQQQQQQQQLQQQQQQQQQQQLQQQQQQqQQQQQ
QQQQQqqqQQLQQQQQQQQQQQQQQQQQQLQQQQQQQQQQQLQQQqqqqQQQQQ
QQQQQQQqqQLQQQQQQQQQQQQQQQQQQLLQQQQQQQQQQLQQQqQQQQQQQQ
QQQQQQQQqQLQQQQQQQQQQQQQQQQQQLLLLLLLLLLLLLQQQqQQQQQQQQ
QQQQQQQQqQLQQQQQQQQQQQQQQQQQQLQQQQQQQQQQQLQQQqQQQQQQQQ
QQQQQQQQqQLLLLLLLLLQQQQQQQQQQLQQQQQQQQQQQLQQQqqqqQQQQQ
QQQQQQQQqQQQqQQQQQLQQQQQQQQQQLQQQQQQQQQQQLQQQQQqqQQQQQ
QQQQQQQQqqqqqQQQQQLQQQQQQQQQQLQQQQQQQQQQQLLLLLQqqQQQQQ
QQQQQQQQQQQQqQQQQQLQQQQQQQQQQLQQQQQQQQQQQQQQQLQqqQQQQQ
QQQQQQQQQQQQqQQQQQLLLLLLLLLLLLLLLLLLLLLLLLLLALQqqQQQQQ
QQQQQQQQQQQQqqqQQQQQQQQQLQQQQQQQQQQQQQQQQQQQqQQqqQQQQQ
QQQQQQQQQQQQqQqqQQQQQQQQLQQQQQQQQQQQQQQQqqqqqqqqqQQQQQ
QQQQQQQQQQQQqQqqQQQQQQQQLQQQQQQQQQQQQQQQqQQQqQQQQQQQQQ
QQQQQQQQQQQQQQQQQQQQQQQQLQQQQQQQQQQQQQQQqqqqqQQQQQQQQQ
QQQQQQQQQQQQQQQQQQQQQQQQLQQQQQQQQQQQQQQQQQQQQQQQQQQQQQ
QQQQQQQQQQQQQQQQQQQQQQQQLQQQQQQQQQQQQQQQQQQQQQQQQQQQQQ
QQQQQQQQLLLLLLLLLLLLLLLLLLLLLLLLLLLLLLLLLLLLLLQQQQQQQQ
QQQQQQQQLQQQQQQQQQQQQQQQLQQQQQQQQQQQQQQQQQQQQLQQQQQQQQ
QQQQQQQQLQQQQQQQQQQQQQQQLQQQQQQQQQQQQQQQQQQQQLQQQQQQQQ
QQQQQQQQLQQQQQQQQQQQQQQQLQQQQQQQQQQQQQQQQQQQQLQQQQQQQQ
QQQQQQQQLQQQQQQQQQQQQQQQLQQQQQQQQQQQQQQQQQQQQLQQQQQQQQ
QQQQQQQQLQQQQQQQQQQQQQQQLQQQQQQQQQQQQQQQQQQQQLQQQQQQQQ
QQQQQQQQLQQQQQQQQQQQQQQQLQQQQQQQQQQLLLLLLLLLLLQQQQQQQQ
QQQQQQQQLLLLLLLLLLLLLLLLLQQQQQQQQQQQQQQQQQQQQLQQQQQQQQ
QQQQQQQQQQQQQQQQQQQQQQQQQQQQQQQQQQQQQQQQQQQQQLQQQQQQQQ
QQQQQQQQQQQQQQQQQQQQQQQQQQQQQQQQQQQQQQQQQQQQQLQQQQQQQQ
QQQQQQQQQQQQQQQQQQQQQQQQQQQQQQQQQQQQQQQQQQQQQLQQQQQQQQ
QQQQQQQQLQQQQQQQQQQQQQQQQQQQQQQQQQQQQQQQQQQQQLQQQQQQQQ
QQQQQQQQLQQQQQQQQQQQQQQQQQQQQQQQQQQQQQQQQQQQQLQQQQQQQQ
QQQQQQQQLQQQQQQQQQQQQQQQQQQQQQQQQQQQQQQQQQQQQLQQQQQQQQ
QQQQQQQQLLLLLLLLLLLLLLLLLLLLLLLLLLLLLLLLLLLLLLQQQQQQQQ
QQQQQQQQLQQQQQQQQQQQQQQQQQQQQQQQQQQQQQQQQQQQQLQQQQQQQQ
QQQQQQQQLQQQQQQQQQQQQQQQQQQQQQQQQQQQQQQQQQQQQLQQQQQQQQ
QQQQQQQQLQQQQQQQQQQQQQQQQQQQQQQQQQQQQQQQQQQQQLQQQQQQQQ
QQQQQQQQLQQQQQQQQQQQQQQQQQQQQQQQQQQQQQQQQQQQQLQQQQQQQQ
QQQQQQQQQQQQQQQQQQQQQQQQQQQQQQQQQLLLLLLLLLLLLLQQQQQQQQ
QQQQQQQQQQQQQQQQQQQQQQQQQQQQQQQQQQQQQQQQQQQQQQQQQQQQQQ
QQQQQQQQQQQQQQQQQQQQQQQQQQQQQQQQQQQQQQQQQQQQQQQQQQQQQQ
QQQQQQQQQQQQQQQQQQQQQQQQQQQQQQQQQQQQQQQQQQQQQQQQQQQQQQ
QQQQQQQQQQQQQQQQQQQQQQQQQQQQQQQQQQQQQQQQQQQQQQQQQQQQQQ
QQQQQQQQQQQQQQQQQQQQQQQQQQQQQQQQQQQQQQQQQQQQQQQQQQQQQQ
QQQQQQQQQQQQQQQQQQQQQQQQQQQQQQQQQQQQQQQQQQQQQQQQQQQQQQ
QQQQQQQQQQQQQQQQQQQQQQQQQQQQQQQQQQQQQQQQQQQQQQQQQQQQQQ