VVVVVVVVVVVVVVVVVVVVVVVVVVVVVVVVVVVVVVVVVVVVVVVVVVVVVVVVVVVVVVVVVVVVVV
VBSaaaaaaaaaaaaaSBBBBBBBBBBBBBBBBBBBBBBBBBBBBBBBBBBBBBBBBBBBBBBBBBBBBB
VBsBBBBBBBBBBBBBsBBBBBBBBBBBBBBBBBBBBBBBBBBBBBBBBBBBBBBBBBBSaaSBBBBBBB
VBsBBBBHTTTBBBBBsBBBBBFBBBBBBFBBBBBBFBBBBBBFBBBBBFBBBBBFBBBsBBsBBBBBBB
VBsBBBBTTTTBBBBBsBBBBBBBBBBBBBBBBBBBBBBBBBBBBBBBBBBBBBBBBBBsBBsBBBBBBB
VBsBBBBTTTTGGGGGGGGGGGGGGGGGGGGGGFGGGGGGGGFGGGGFGGGGGFGGGGGGFBGBBBBBBB
VBsBBBBFAAAFFFFFGBBBBBBBBBBBsBBBBBBBBBBBBBBBBBBBBBBBBBBBBBBBBBBBBBBBBB
VBsBBBBSSSSSSSSSShTTTbhTTTBBsBBBBBBBBBBBBBBBBBBBBBBBBBBBBBBBBBBBBBBBBB
VBsBBBBBBBBBBBBBBTTTTbTTTTFGAAAAAAAAAAAAAAAAAAAAAAaaaaaaaaSHTTTBBBBBBB
VBsBBBBGGGFFFFFFFTTTTFTTTTFGAGGGGGGGGGGGGGGGGGGGGGGGGFVVVVsTTTTBBBBBBB
VBsBBBBGGGAAAAAAAAAAAVVVAAAAAGGGGGGGGGGGGGGGGGGGGGGGGFVVVVsTTTTBBBBBBB
VBsBBBBGbFbFbGGGGGGGAAAAAGGGAAAAAAAAAAAAAAAAAAAAAAAAAAAAAAAAAAABBBBBBB
VBsBBBBGFbFbFGGGGGFGGGGFGGGGAGGPTTTGGGGGFGGGGGFGGGGGFGFFFGsbGbGBBBBBBB
VBsBBBBVVVVVVVVVVVVVVVVVVVVVAVVTTTTVVVVVVVVVVVVVVVVVVVVVVVsVVVVBBBBBBB
VBsBBBBGBBBBGGGBBBGGGGFGGGGGAVVTTTTFFGGGGGFGFGFGFGGGGGFFFFsFFFFBBBBBBB
VBsBBBBGGGGBGGBGGGGGGGGGFGGGAVVTTTTFFGGFbFBFbFBFbFGGGGFFFFsFFFFBBBBBBB
VBsBBBBGBGGBGGGBGGGGGGGGGGGGAVVTTTTFFGGGGGFGFGFGFGGGGGFFFFsFFFFBBBBBBB
VBsBBBBGBGGBGGGGBGGGFGGGGGFGAAAAAAAAAAAAAAAAAAAAAAAAAAAAAAAGGGGBBBBBBB
VBsBBBBGGBBGGGGGGBGGGGGGGGGGGGGGFGGGGGGGGGGGGGGGGGGGGGGGGGGGGGGBBBBBBB
VBsBBBBBGGGGGGBBBGGBBBBBBGGGGGGGGGGGGFGGGGGGFGGGGGGFGGGGFGGGGGGBBBBBBB
VBsBFFFBGGGGGGGGGGGGGGGGGGBBBBBBBBBBBBBBBBBBBBBBBBBBBBBBBBBBBBGBBBBBBB
VBSaaGGBBBBBBBGBBBBBBBBBBBBBBBBBBBBBBBBBBBBBBBBBBBBBBBBBBBGGGGGBBBBBBB
VBBBFFFBBBBBBBGGGGGGGGBBBBBBBBBBBBBBBBBBBBBBBBBBBBBBBBBBBBGBBBBBBBBBBB
VBBBBBBBBBBBBBBBBBBBBVVBBBBBBBBBBBBBBBBBBBBBBBBBBBBBBBBBBBBBBBBBBBBBBB
VVVVVVVVVSSSSSSSSSSSSSVVVVVVVVVVVVVVVVVVVVVVVVVVVVVVVVVVVVVVVVVVVVVVVV
VVVVVVVVVSSVVVVVVVVVVVVVVVVSVVVVVVVVVVVVVSaaaaSaaaSVVVVVVVVVVVVVVVVVVV
VVVVVVVVVSSVVVVVVVVVVVVVVVVsVVVVVVVVVVVVVsVVVVVVVVsVVVVVVVVVVVVVVVVVVV
VVVVVVVVVSSSSSSSSSSSSSSSSSSSSSSSSSSSSSSSSSSSSSSSSSSSSSSSSSSSSSVVVVVVVV
VVVVVVVVVVVVVVVVVVVVVsVVVVVVVVVVVVVVVVVVVVVVVVVVVVVVVVVVVVVVSSVVVVVVVV
VVVVVVVVVVVVVVVVVVVVVSVVVVVVVVVVVVVVVVVVVVVVVVVVVVVVVVVVVVVVSSVVVVVVVV
VVVVVVVGGGGGGGGGGGGGVVVGGGGGGGGGGGGGGGGGGGGGGGGGGGGGGGGGGGGGGGGVVVVVVV
VVVVVVVGGGGGGGGGGGGGGGGGGGGGGGGGGGGGGGGGGGGGGGGGGGGGGGGGGGGGGGGVVVVVVV
VVVVVVVGGGGGGGGGGGGGGGGGGGGGGSSAAASSGGGGGGGGGGGGGGGGGGGGGGGGGGGVVVVVVV
VVVVVVVGGGGGGGGGGGGGGGGGGGGGGBSAAASBGGGGGGGGGGGGGGGGGGGGGGGGGGGVVVVVVV
VVVVVVVGGGGGGGGGGGGGGGGGGGGGGSBAAABSGGGGGGGGGGGGGGGGGGGGGGGGGGGVVVVVVV
VVVVVVVGGGGGGGGGGGGGGGGGGGGGGSSBABSSGGGGGGGGGGGGGGGGGGGGGGGGGGGVVVVVVV
VVVVVVVGGGGGGGGGGGGGGGGGGGGGGSSSBSSSGGGGGGGGGGGGGGGGGGGGGGGGGGGVVVVVVV
VVVVVVVGGGGGGGGGGGGGGGGGGGGGGSBSSSBSGGGGGGGGGGGGGGGGGGGGGGGGGGGVVVVVVV
VVVVVVVGGGGGGGGGGGGGGGGGGGGGGGGGGGGGGGGGGGGGGGGGGGGGGGGGGGGGGGGVVVVVVV
VVVVVVVGGGGGGGGGGGGGGGGGGGGGGGGGGGGGGGGGGGGGGGGGGGGGGGGGGGGGGGGVVVVVVV
VVVVVVVGGGGGGGGGGGGGGGGGGGGGGGGGGGGGGGGGGGGGGGGGGGGGGGGGGGGGGGGVVVVVVV
VVVVVVVGGGGGGGGGGGGGGGGGGGGGGGGGGGGGGGGGGGGGGGGGGGGGGGGGGGGGGGGVVVVVVV
VVVVVVVGGGGGGGGGGGGGGGGGGGGGGGGGGGGGGGGGGGGGGGGGGGGGGGGGGGGGGGGVVVVVVV
VVVVVVVGGGGGGGGGGGGGGGGGGGGGGGGGGGGGGGGGGGGGGGGGGGGGGGGGGGGGGGGVVVVVVV
VVVVVVVGGGGGGGGGGGGGGGGGGGGGGGGGGGGGGGGGGGGGGGGGGGGGGGGGGGGGGGGVVVVVVV
VBBBBBBBBBBBBBBBBBBBBBBBBBBBBBBBBBBBBBBBBBBBBBBBBBBBBBBBBBBBBBBBBBBBBB
VBBBBBBBBBBBBBBBBBBBBBBBBBVVVSVVVBBBBBBBBBBBBBBBBBBBBBBBBBBBBBBBBBBBBB
VBBBBBBBBBBBBBBBBBBBBBBBBBVVVSVVVBBBBBBBBBBBBBBBBBBBBBBBBBBBBBBBBBBBBB
VBBBBBBBBBBBBBBBBBBBBBBBBBBBBBBBBBBBBBBBBBBBBBBBBBBBBBBBBBBBBBBBBBBBBB
VBBBBBBBBBBBBBBBBBBBBBBBBBBBBBBBBBBBBBBBBBBBBBBBBBBBBBBBBBBBBBBBBBBBBB